.........
.........
..MrrC...
Crrbbbb..
#r#####..
.r.C.TT..
