...M.....
...gg.C..
.C.pg.V..
.Vgpp*...
..ggWpC..
..opgrV..
..C*gr...
..VWpo...
..grpoC..
..ggop#..
..oWgo...
TTopgo...
