#########
.V*.#Mb..
.Vr.#bb..
MVrCVWbTT
#####*###
.##.W#W..
