...W.....
..g*.....
..gM.....
..brr....
.CrrC#...
.#rb##...
..gb.....
..WrW....
..WrW....
..WWWTT..
