...M.....
...WW....
..WWW....
..WbW....
..bby....
..ybp....
..pyp....
..bby....
.ypby....
.pyyp....
.pb*yy...
.#VVV#...
.....TT..
WW...##..