..bbW....
..Wbr....
..brr....
..bbr....
..rWg....
M.rrbTT..
WWggbWW..
