...C.....
M..o#....
bb.r##...
##orC##..
.#ppr....
.###r....
...#ooTT.