...gg....
...gb....
##.bb....
###bb.y..
M==ggCyTT
##====###
##WgbW...
..bggb...
..bWWb...