.C.......
.r.......
rrp...M..
#bgC.yy..
#W*g.y#..
#bW####..
yypp.C#..
###y.##..
...yr....
...gb....
TT.gp....
