..CgMbC..
.VVg#bW.C
.#yy#W#.W
C#*y#*#.W
b#VV#V#.g
bb.....*g
V#######V
*....C.*.
###*bbV##
..#Wgg#..
TTVrrb#..
###org#..
..#oog#..