....C....
...roo...
...ryo...
.*.yyy.*.
VV.oor.VV
VM.yor.MV
VV.yyo.VV
TT.rro...
