....gr...
....gr...
....Cb...
....gg...
....rr...
...Mgb...
...#br...
....rr...
..TTbg...