Mrr.C....
#roorr...
.#prbb...
.r0oo#...
Cbbp#....
rbo#.....
#r#......
#0#......
....TT...