........M
C....r..r
rr...r..r
Cr...bb.M
r####r###
r....W.##
bb####*##
bo....###
oo.....##
ppp..TT##
