..CW..M..
..g*..#..
..gpg##..
..ygg#...
..Wp##...
..pyy....
..WWyTT..
