.C.......
.W....M..
#gb#####.
.bMbg.C#.
#brgb.##.
ggrrb..#.
rrbgg..#.
#rg#####.
.rg......
.bg.TT...