...W.....
..MWTT...
..#W##...
..rgg....
..gbg....
..bbr....
..rbg....
..rrb....