...g.oW..
..WgWoWr.
.Cg*rr*oM
###V##V##
......C..
TT..#.#..
