....Wg...
...Wyb...
...gyW...
...yby...
...bgg...
.M.g*b.C.
###VVV###
.........
...oo....
...obb...
...rrb...
...oTT...
