.......rr
.......gr
.......bb
......MgC
......#rr
.......gb
.....TTbg
.....##gg
.......br
