....WW...
....WW...
....W*gbb
TT..bbggM
####VV###
TT..CCooM
###*V####
C.gg....M
TTg#.####
