......C..
M.....p..
####prr.#
C...#r###
bb...MbbC
boppp###p
orpo#.W#y
rr##.bb#y
TT..ooW*W