#.W..bCr.
#MW..brr.
##0#.gg#.
#M...rr..
##W#.br..
.#0#.gg..
...TT####