........C
.M======b
.g==TT==b
.g===C==b
C#..#b#rr
b===bb.#g
rrTT====g
####....#