........#
.......#.
.....W#M.
.....#bbp
....#ppWC
...##CCpb
.W#.ppbCb
.#..bbpWb
##TTppbbp