...rC....
...gr....
..bgr....
..rgg....
Mggbr....
###TT....