....g....
...br....
..rrb....
..Wgr....
###rb....
W..rg....
WWMbgTT..
