.b.C.....
.o.o.C...
bb.oCb.oM
CoMb#bMo#
#b#b#o#b#
.W#b.o#b.
.W.W.o.W.
.*.W*W.W.
.W.TTW*W.
