..M......
W.0.W....
WW..0....
##..CTT..
..000##..
......M..
....000..
.M.......
.0.#TT...
.TT###...
.###.....
......0..