..WW.....
..ypW....
TT*yrW..M
##rbbrW##
..rp####.
..poo....
..pp#....
