....g....
...gg....
##.bb....
###bb.y..
M==ygCrTT
##yygg###
##WybW...
..rr==..C
..bWWb.TT