......gC.
.....Mgg.
.....#rr.
......rr.
....TTbb.
....##bg.
......gg.