.....#.C.
.....#.p.
...W.#.b.
..WWMV*W.
#######W.
#..bpW#bb
#Cbbp*Vpb
#V#####V#
#W*#WV.C#
#VV#CVWW#
#b.######
#bp#....#
#ppV*CTT#
