.M.......
.b.....M.
gbr####WW
grb...g*g
bWbrgbbgg
*WrrTTWWW
