...WWW...
.C.WMW...
.#.WWW...
..bbbg...
..rrgg...
..g###...
..gg..TT.