...C.C...
...W.W..C
C.*V.V*.y
pMWV.VWMy
p##...##p
bb..#..pp
##.###.##
C.......C
bb.....yy
pb#####yb
pp.TT..bb
