....rC...
....rM...
....gb...
....rb...
....bg...
....rbb..
..TTgrM..
..###r#..
....bgg..