...W.W...
...r.oW..
MW.r.00TT
#0#o#r.##
###0#r##.
.##o###..