....g....
...bgg...
..Cbbg..M
VV##g#VV#
...#*#W*.
...#V#gW.
TT....WC.
