.........
.........
..Mrrc...
crrbbbb..
#r#####..
.r.c.TT..
