C#..M..WC
bb..M..*b
prr###rrb
bbr###rrp
rp#####yW
r#####ppy
pp.TT.pWW