....MbC..
....gbC..
....brb..
....rMb..
....brg..
..g.WWg..
Cgr===g..
##ggbb#..
..rbgg...
..brrb.TT
..rbbr###
..b===..C
..#rgg.TT
...rbrrWW