...bgg...
.C.brM...
.#.#r#...
.C..gM...
.#.#b#...
.C..rM...
.#.#g#...
...gbb...
rr.##g...
rggTTb...