......C..
..C..pp..
..p.M#p..
#Mpp##b..
##WWpbpM#
.WbbWbp##
.pW*pWb..
.bbbWbW..
.pppWbb..
.#ggb#*..
.bgbggb..
.bbgTTb..