.C.*..M..
C#VV###..
rW...*...
r*..yy..C
#V##VV###
..yW.....
WTTy.rW..
W##WrWr..
