...*.....
...r..*..
...r.pr..
.Mbb.bb.C
.##prpg##
...b##g..
.M.bWCrTT