....M....
....bg...
....bg...
....rr.C.
..C.bb.#.
..#.gg#..
....gr.C.
...#rr.#.
..Cbb##..
..#bggTT.