...b.....
..bb.....
.MbWbgbC.
.#gbWWb#.
.#bgWgg#.
.#bgbTT#.
.#######.
