......M..
....Wrg..
....r*g..
...WWWg..
...b*WW..
..#WWbW..
#W##WWWTT