.M..rC...
WW##r#...
W*C.bb#..
*W#pr#*..
W*#p#.r..
*W#p..rWC
WW#####W#
rr..TT#C.