####.####
.#.##WC#.
.#Wr#WW#.
M.*rrbbTT
##VV#*###
.*..###..
