.C.......
.gbM.....
.bg##....
ggb##....
bob##....
gbo##....
gg====.Cy
b#####yyg
######TTT