...C.....
...rb....
..WrW....
.MW*W....
.#WrW.C..
..brb.#..
.bW*W....
.#Wyy....
..rbW..TT