.M.......
.b=====C.
.bg....r.
.ggC===r.
.###..gg.
.C====gr.
.rrTT#bb.