....*....
....b....
....pb...
...bpb...
.M.pbp.C.
.VV#V#V#.
TT...#.*.