...M.....
...W.....
...WW....
...bW....
...gg....
.#gbbb.#.
.#bbggg#.
.#ggWTT#.
.##VV###.
..#b*#...
..#bb#...
