.b.......
.yb....b.
Mby...Cb.
#bb###ob.
.##...oo.
......bb.
...Cggob.
...bboo#.
TTbboobb.
