....g....
...gbb...
...WW*...
...bbW...
...*Wg...
.M.ggbTT.
