M.0.C....
0...0.C..
0....M0..
.C...0...
.0...0.C.
.0.....0.
....0.0..
##0##0###
.........
..bb.....
..gbb....
..ggbgg..
.bbbTTg..