..M......
.Crgr....
.gbbg....
.r#bg....
.rCgr....
.gbbg....
.#gr#....
.bbrb....
.rgrg....
.rgb#....
.#bbg....
..rrgTT..
