.g.......
Mp.C..C..
ppgb.gppM
0gbbpggp#
.#Mppbb#.
..#ggb0..
...0g#...
...TT....