.#b#.#...
.#0#.#...
C#g#*#...
0#0#0#...
.....MM..
bbg00##..
b*bg.TT..