#M......#
#W.....C#
#*WWW#W##
#r#rW*TT#
#r.b#####
#bbrr...#
#rrbr...#