...p.....
..po.....
C.opp..M.
#.Wo####.
TTWooppC.
###0##p#.
Crr.####.
0####r...
..rrppTT.
#####p##.